11111111111111111111111
1PC10000000000000000001
1EC10110001101011101101
10010101010101010100101
10100100100101010100101
10000100000101010111111
10100000000000000000001
11111111111111111111111